

NO include/textures/xpm/abadie/abadie_N.xpm
WE include/textures/xpm/abadie/abadie_W.xpm
SO include/textures/xpm/abadie/abadie_S.xpm
EA include/textures/xpm/abadie/abadie_E.xpm

F 71,24,1
C 62,64,71

111111111111111111111111111111
10111111111111111111111111111
100001111110000100001000000111
10000000S000000000000000000000111
1111111111111111111111111111110001
100000010000000000000000000111111
1000000100111111111111111111
100000010010000000100000001
1000000100100000001000000001
1110011100100000001000000001
1000000000000000001000000001
1011111111111111111111001111
1000000000000000000000000001
1111111111111111111111111111