
F 71,24,1
C 62,64,71


NO include/textures/xpm/mercadona/mercadona.xpm
WE include/textures/xpm/mercadona/pasillo.xpm
SO include/textures/xpm/mercadona/pasillo.xpm
EA include/textures/xpm/mercadona/pasillo.xpm

1111111111111111111111111111
1000011111100001000010000001
10000101000000000000000000011
10000000011000W100001000000011
100000010000000000000000000111
1000000100111111111111111111
111111111111111111111111111111111
1000000100100000001000000001
1110011100100000001000000001
1000000000000000001000000001
1011111111111111111111001111
1000000000000000000000000001
1111111111111111111111111111