
F 71,24,1
C 62,64,71


NO /include/textures/xpm/42/images.xpm
WE /include/textures/xpm/42/images.xpm
SO /include/textures/xpm/42/images.xpm
EA /include/textures/xpm/42/images.xpm


1111111111111111111111111111
100000000000000000W0000010111
11111111100000000000000000001
11111111111111111110000000001
10000000000000000000000000001
10000000000000000000000000011
11111111111111111111111111111